30
.....XXXXXXXXXXXXXXXXXXXXXXXXXXXXXXXXXXXXXXXX
.....XXXXXXXXXXXXXXXXXXXXXXXXXXXXXXXXXXXXXXXX
.XXX...XXXXXXXXXXXXXXXXXXXXXXXXXXXXXXXXXXXXXX
.XXX.........X...............................
.............................................
....4........................................
.............X...............................
.............XXXXXXXXXXXXXXXXXXXXXXXX........
..............XXXXXXXXXXXXXXXXXXXXXXX........
XXXXXXXXXXXXXXXXXXXXXXXXXXXXXXXXXXXXX........
XXXXXXXXXXXXXXXXXXXXXXXXXXXXXXXXXXXXX........
XXXXXXXXXXXXXXXXXXXXXXXXXXXXXXXXXXXXX........
XXXXXXXXXXXXXXXXXXXXXXXXXXXXXXXXXXXXX........
XXXXXXXXXXXXXXXXXXXXXXXXXXXXXXXXXXXXX........
XXXXXXXXXXXXXXXXXXXXXXXXXXXXXXXXXXXXXX.......
XXXXXXXXXXXXXXXXXXXXXXXXXXXXXXXXXXXXXX.......
XXXXXXXXXXXXXXXXXXXXXXXXXXXXXXXXXXXXX........
XXXXXXXXXXXXXXXXXXXXXXXXXXXXXXXXXXXXXXXX..XXX
XXXXXXXXXXXXXXXXXXXXXXXXXXXXXXXXXXXXXXXX..XXX
XXXXXXXXXXXXXXXXXXXXXXXXXXXXXXXXXXXXX.X......
XXXXXXXXXXXXXXXXXXXXXXXXXXXXXXXXXXXXX.....X..
XXXXXXXXXXXXXXXXXXXXXXXXXXXXXXXXXXXXX.X....X.
XXXXXXXXXXXXXXXXXXXXXXXXXXXXXXXXXXXXX.X....X.
XXXXXXXXXXXXXXXXXXXXXXXXXXXXXXXXXXXXX........
....X.......XX..XXXXXXXXXX.X....XX...........
.............................................
.............................................
.............................................
.............................................
.......S.....................................
