15
XXXXXXXXXXXXXXXXXXXXXXXJX
XXXXXXXXXXXXXXXXXXXXXXX.X
XXXXXXXXX....XXX........X
X................X...X..X
X..XX............X...X..X
X..XX...................X
X..XX...................X
X.............XXXX...XXXX
XXXXXXX.......XXXX...XXXX
XXXXXXX.......XXXX......X
XXXXXXX.......XXXX......X
XXXXXXX.......X.X....X.XX
XX...XX.......X........XX
XX............X......XXXX
XXXXXXXXXXXVVVXXXXXXXXXXX
